--------------------
--------------------
--------------------
--------------------
--------------------
--------------------
-+---+-+---+-+++++--
--+-+---+--+----+---
---+-----+++---+----
--+-+--+---+--+-----
-+---+--+++--+++++--
--------------------
--------------------
--------------------
--------------------
--------------------
--------------------
--------------------
--------------------
--------------------
--------------------
--------------------
--------------------
--------------------
--------------------
MaxSize20x25